20 20
####################
#Y-----------------#
###-#-#-#--#-#-#-###
#------------------#
#####-###--###-#####
#------------@---@-#
#-#---########---#-#
#------------------#
#-##-#-#----#@#@##-#
#---#--- BP -------#
#--#-#-# IC #-#-#--#
#------------------#
#--##-#-#--#-#-##--#
#------------------#
#--##-##-##-##-##--#
#------------------#
#-###-###--###-###-#
#------------------#
####################
####################
